*******************
*          *     E*
*    *     *    ***
*    *     *      *
*    *     *      *
*    *     *      *
*S   *            *
*******************